Roll No,Name,Subject1,Subject2,Subject3,Total
1,Ram,78,87,98,263
2,Shyam,67,76,77,220
3,Harish,88,76,65,229
4,Mohan,67,89,77,233
5,Mukesh,65,78,68,211
6,Bharat,67,55,45,167
7,Akhil,48,78,67,193
8,Raju,59,77,76,212
9,Sanjay,78,89,87,254
10,Govind,88,77,92,257
